#########################################
#.....#...........#.....#...#...........#
###.#.#######.###.#.###.#.#.###########.#
#...#.#.....#.#...#.#...#.#.........#...#
#.###.#.###.#.###.#.#.###.#########.#.#.#
#.#.#.#.#...#...#...#.#.....#.......#.#.#
#.#.#.#.#.#####.#####.#.#####.#######.#.#
#.#.....#.#.....#.....#.#.....#.......#.#
#.#######.#.#####.#####.#.#####.#######.#
#.......#...#...#...#...#...#...#.......#
#.#####.#####.#.###.#.#####.###.#.#######
#.....#.#.#...#...#.#.#.....#...#.#.....#
#######.#.#.#.#####.#.#.#####.###.#.###.#
#...#...#.#.#.......#.#.....#.#.#.#.#...#
#.#.#.###.#.#########.#####.#.#.#.#.#.###
#.#...#...#.#...#...#...#...#.#...#.#...#
#.#######.#.#.#.#.#####.#.###.#.#######.#
#...#...#...#.#...#.....#.#...#.#.....#.#
#.#.#.#.#.###.#.###.#####.###.#.#.###.#.#
#.#...#.#.#...#.#.......#.#...#...#.#.#.#
#######.#.#.###.#.#####.#.#.#######.#.#.#
#.......#.#...#.#...#.#.#.#.#...#...#.#.#
#.#######.###.#####.#.###.#.###.#.#.#.#.#
#...#...#...#.#.....#.#...#...#...#.#.#.#
#.#.###.###.#.#.#####.#.#####.#.###.#.#.#
#.#.#.....#...#.....#.#.#.....#.#.#...#.#
#.#.#.#.#####.#####.#.#.###.###.#.#####.#
#.#.#.#.#.....#.....#...#...#.#...#...#.#
#.#.#.###.#####.#########.###.###.#.#.#.#
#.#.#...#...#...#.....#.....#.....#.#.#.#
###.###.#.###.#####.#.###.#.#.#####.#.#.#
#...#...#.#...#.....#...#.#.#.#.....#.#.#
#.###.###.#.#####.#####.###.#.#.###.#.#.#
#.#O......#.....#.#...#.....#.#...#.#...#
#.#############.#.#.#.#######.###.#.###.#
#.#.......#...#.#...#.#.#...#.#...#...#.#
#.#.#####.#.#.#.#.###.#.#.#.#.#####.#.#.#
#.#.#...#.#.#.#.#.#...#...#...#...#.#.#.#
#.#.###.#.#.#.#.###.###.#######.#.###.#.#
#.......#...#.......#...........#.....#.#
#########################################
